1111111111
1000000001
1000000001
1000000001
1111100001
1000000001
1000000001
1000000001
1000000001
1000010001
1000010001
1000010001
1000010$01
1000010001
1111111111